
Découvrez nos résidences étudiantes en France

   Résidence étudiante Angers  |  Résidence étudiante Aubervilliers  |
   Résidence étudiante Avignon  |  Résidence étudiante Bastia  |
   Résidence étudiante Bois-colombes  |  Résidence étudiante Bordeaux  |
   Résidence étudiante Bussy-Saint-Georges  |  Résidence étudiante
   Cergy-Pontoise  |  Résidence étudiante Champs-sur-Marne  |  Résidence
   étudiante Courbevoie  |  Résidence étudiante Créteil  |  Résidence
   étudiante Dijon  |  Résidence étudiante Drancy  |  Résidence étudiante
   Evry  |  Résidence étudiante Fréjus  |  Résidence étudiante Gentilly
   |  Résidence étudiante Ivry-sur-Seine  |  Résidence étudiante
   L'Hay-les-Roses  |  Résidence étudiante La Valette - Toulon  |
   Résidence étudiante Le Mans  |  Résidence étudiante Lognes  |
   Résidence étudiante Loos  |  Résidence étudiante Lyon  |  Résidence
   étudiante Maisons-Laffitte  |  Résidence étudiante Malakoff  |
   Résidence étudiante Marseille  |  Résidence étudiante Massy  |
   Résidence étudiante Meaux  |  Résidence étudiante Menton  |  Résidence
   étudiante Montmagny  |  Résidence étudiante Nancy  |  Résidence
   étudiante Nanterre  |  Résidence étudiante Nantes  |  Résidence
   étudiante Nice  |  Résidence étudiante Nîmes  |  Résidence étudiante
   Noisy-le-Grand  |  Résidence étudiante Noisy-le-Sec  |  Résidence
   étudiante Orsay  |  Résidence étudiante Paris  |  Résidence étudiante
   Quincy sous Sénart  |  Résidence étudiante Rennes  |  Résidence
   étudiante Saint-Denis  |  Résidence étudiante Saint-Ouen  |  Résidence
   étudiante Saint-Raphaël  |  Résidence étudiante Sceaux  |  Résidence
   étudiante Strasbourg  |  Résidence étudiante Suresnes  |  Résidence
   étudiante Toulon  |  Résidence étudiante Villejuif

   Conformément à la législation relative à la protection des données,
   nous vous informons que ce site utilise des cookies à des fins de
   statistiques. En cliquant sur le bouton 'Accepter', vous autorisez les
   services tiers que nous utilisons à éventuellement déposer un ou
   plusieurs cookies sur votre ordinateur. Pour en savoir plus, consultez
   nos mentions légales
   Je refuse J'accepte
